30.ox
o.o...oo...oo.o...o..o..oo..oo
.oo..o.oooo...o.o.o..o...o.o..
...o..ooooo.ooo..o..o..o......
.....o...o.o......o....oo.o.o.
....o...o.oo.ooo...o...oo.o...
..o.....o.o.o.o.o..o...o..oo..
.o........ooo......o.oo.......
oo.oo..oooo..oooo..o.o.o.o.o.o
..o.o.o.oo...oo.o....o..ooo.o.
.oo.o....o....o..o.o...ooo...o
..o.....oo.o..o...o.......o...
oo.oo.....o.o.....o.oo..oo...o
.o..ooo.o.o....o..oo..o.oooooo
o.....o..oo..o.o.o..ooo...o..o
o.oo..oo.o.o...oo.o.o.o....o..
...o...o.ooo..o.o.oo.o..oo..o.
oo.o.o.oo...o.o.oo.o..oo....o.
o..oo.oo.oo....o....o.....o...
oo.oooo.o.o.o.o..o......o.o...
..oooo.o.oo.....oooooo.o..o..o
.o..oo..o.o.ooo..oo..oo..o..o.
.o...oo.o..o...o.o.o...o....o.
o........o.o.oo.o.oo.oo......o
.oo.o.o....o.oo...ooo..oooo..o
o..ooo..o.o..oo......o....o.o.
oo.o..oo......ooo.o...o.oooo..
oooo.o.oo.o.oo.o.o.oo....o.o.o
..ooo.ooooo..o...o..o.oo.o...o
o.....ooo.o.o..ooo..o.o....o..
oo.....o.ooo......o.oo...o..o.
